0000000000000000
0000000000000000
0000111000000000
1100001000000010
000/00100000001X
0001001010000111
001110001X000000
1100011111010000
9000000000000000
00000000000001XX
00A0000000000111
111XX11X11111111
1111111111111111

